####################
#         E        #
#  ###   ###  ###  #
#  CCC# #CCC# #FC# #
# #CCC# #CCC# #CC# #
# #CCC# #CCC# # #  #
#  ###    ##  #    #
#                  #
######  ############
#         # C     S#
#   ##  #####      #
#   N# C       #N  #
#    ##########    #
#         CC#P     #
####################